SO ../textures/eagle.xpm






NO ../textures/bluestone.xpm
WE	../textures/purplestone.xpm
EA	../textures/greystone.xpm

F 255,124,255
C 120,20,20

1111111111111
100E0000100001
1100000000001
100000000001
1000000000001
1000000000001
1000000000001
1110000001111
1111111111111
