1111111111111111111111
10P10000010C0000000001
1001000010000100000001
1001001001111111111001
1000001000010000000001
100100100000000E000101
1111111111111111111111
